XXXXXXXXXXXXXXXXXXXXXXXXX
X1111111PX11111111111111X
X1X111XX1X111XXXXXX11X11X
X1X111111X111XXXXXX11111X
X1X11XXXXX111XXXXXX11X11X
X1X11111111X111111111111X
X1X1XX111111111111111111X
X1X11111X11XX11X1XXXX1XXX
X1XXXX11X111111X1X11111XX
X1111X11XXXXXXXX1X11X11XX
X1XX1X11111111111X11111XX
X1XX1X11XXXXXXXX1XXX1XXXX
X1111XXXX111111X1XXX1XXXX
X11X11111111XX1X1X1111XXX
X11XX1XX1XX1XX111X1XX1XXX
X11X111111X1111X111XX1XXX
XX1X1X11X111XXXX1X1111XXX
X11X111111XXXXXX1XXXXXXXX
X11XXXX111X11111111X1111X
X11111X1X1X1XXX1111X1111X
XX1XX1X111X1XXX1111111G1X
X111X1XXXXX1XXX1111X1111X
X1E1111111111111111X1111X
X111XXXXXXXXXXXXXXXXXXXXX
XXXXXXXXXXXXXXXXXXXXXXXXX